  ##### 
###   # 
# $   ##
# #    #
# .    #
##$ .  #
 #@  ###
 #####  