   ####    
####  #    
#     #### 
# $ #  . ##
#  #   .  #
## #$$#.  #
##    #####
# @ ###    
#   #      
#####      